####################
#             ## # #
# # ## #####   # # #
# # ## #####  ## # #
# #            #   #
# # ########  #### #
# #              # #
# # ########  ## # #
#                # #
# # ########  ## # #
# #              # #
# # ########  ## # #
#                  #
####################
