##########################
#                   ## # #
# # ## #####   # #       #
# # ## #####  ## #       #
# #            #         #
# # ########  ####       #
# #              #       #
# # ########  ## #       #
#                #       #
# # ########  ## #       #
# #              #       #
# # ########  ## #       #
#                        #
##########################
