######################################
#    #         #                ## # #
# # ## #####   # #       #      ## # #
# # ## #####  ## #       #      ##   #
# #            #         #####  ##   #
# # ########  ####       #           #
# #              #       #           #
# # ########  ## #       #           #
#                #       #   ######  #
# # ########  ## #       #   #####   #
# #              #       #   ###     #
# # ########  ## #       #   ##      #
#                        #   #       #
######################################   
